#################################
#                               #
#                               #
#                               #
#                               #
#    P                          #
#                               #
#                               #
#                               #
#                               #
#                               #
#                               #
#################################
